....#...#####..##.#..##..#....#
..##.#.#.........#.#......##...
#.#.#.##.##...#.......#...#..#.
..##.............#.#.##.....#..
##......#.............#....#...
.....##..#.....##.#.......##..#
.##.....#........##...##.#....#
.##......#.#......#.....#..##.#
##....#..#...#...#...##.#...##.
##........##.#...##......#.#.#.
..#.#........#...##.....#.....#
..#.......####.#....#..#####...
.##..#..#..##.#.....###.#..#...
......###..##.....#.#.#..###.#.
..#.#...#..##.....#....#.#.....
.....#.#...#.###.#..#..........
##.....#...#.#....#..#.#.......
..#...#...#.........##......#..
......#.#...#...#..#...##.#...#
....#.................##.##....
...#......#.............#....##
##..#..#..........#...##.#.#...
....#...##....#..#.#...........
##.#.#.#...#....#........#..#.#
...###..........#...#...#..##.#